1 1 1 1 1 1 1 1 1 1 1 1 1 1 1 1 1 1 1 1 1 1 1 1 1 1 1 1 1 1 1 1
1 3 1 0 0 0 2 2 1 1 B 0 0 0 0 0 0 1 0 0 2 2 0 0 0 0 2 0 A 2 C 1
1 0 1 0 1 1 1 0 0 0 0 1 1 0 1 1 0 1 0 1 1 2 1 1 0 1 1 0 1 1 2 1
1 0 0 0 1 0 0 0 1 1 2 1 0 R 0 1 0 0 0 0 0 2 0 1 0 1 0 0 0 2 2 1
1 0 1 0 0 0 1 0 1 0 0 0 0 1 0 0 1 0 1 1 0 1 0 R 0 2 0 1 0 1 S 1
1 0 0 1 2 1 0 0 0 0 1 1 0 1 1 0 1 0 1 0 0 0 1 0 1 1 0 1 0 0 0 1
1 1 0 0 0 0 0 1 0 1 1 2 2 0 1 0 0 0 C 0 1 0 1 0 0 0 0 1 1 D 1 1
1 D 1 0 1 1 0 1 2 2 X 0 1 0 A 0 1 1 1 0 2 0 0 1 0 1 0 0 0 0 0 1
1 2 1 0 1 1 0 1 0 1 1 0 0 1 1 0 2 0 2 0 1 1 0 0 0 1 1 2 1 1 0 1
1 0 0 0 0 2 0 B 0 2 0 1 0 0 0 0 1 0 1 0 0 0 1 1 0 0 0 0 0 1 0 1
1 0 1 1 B 1 0 1 0 1 0 0 0 1 2 1 1 0 1 0 1 2 2 2 1 1 X 1 0 2 0 1
1 0 0 1 0 1 0 1 2 1 0 1 2 0 F 0 B 0 0 0 2 1 1 F 1 2 2 2 0 1 0 1
1 1 2 2 2 1 0 0 0 0 0 1 0 1 1 2 1 1 0 1 2 2 2 P 2 2 1 1 0 1 0 1
1 0 0 1 0 0 0 1 1 0 1 0 0 0 0 0 0 1 0 1 2 1 1 2 1 2 2 2 0 1 0 1
1 0 1 0 0 1 0 2 0 0 0 0 1 1 A 1 0 0 0 0 0 0 1 2 C 1 1 1 0 0 S 1
1 2 1 0 1 1 R 1 0 1 1 0 0 1 2 1 0 1 0 1 1 0 1 1 F 2 0 1 0 1 2 1
1 D 2 0 2 2 0 1 0 2 C 1 0 0 2 2 0 1 0 2 2 0 X 2 2 1 0 0 F 2 2 1
1 1 1 1 1 1 1 1 1 1 1 1 1 1 1 1 1 1 1 1 1 1 1 1 1 1 1 1 1 1 1 1

