1 1 1 1 1 1 1 1 1 1 1 1 1 1 1 1 1 1 1 1 1 1 1 1 1 1 1 1 1 1 1 1
1 3 0 2 2 0 0 0 0 1 0 0 0 B 1 1 1 H 0 0 0 0 0 0 0 0 0 B 2 2 D 1
1 0 1 1 0 1 1 1 2 1 2 1 1 2 0 0 0 0 1 1 0 1 1 C 1 1 0 1 1 1 2 1
1 2 1 0 0 0 0 0 0 0 0 0 0 0 1 2 1 0 0 1 0 1 2 2 0 1 0 2 0 1 2 1
1 2 2 0 1 2 1 1 1 0 1 1 0 1 1 2 1 1 0 2 0 2 2 1 0 0 R 1 0 0 0 1
1 1 1 0 1 0 0 R 0 0 0 2 0 0 0 0 X 0 0 1 0 1 0 1 1 0 1 1 1 1 0 1
1 0 0 2 1 0 1 1 0 1 1 0 1 V 1 1 2 1 2 1 0 0 V 1 0 0 0 0 0 0 0 1
1 B 1 0 0 0 0 A 2 1 0 0 0 0 1 1 2 1 2 2 0 1 0 2 0 1 1 A 1 0 1 1
1 2 1 1 0 1 0 1 0 1 0 1 1 0 2 2 P 2 2 1 1 1 0 1 0 X 0 0 2 0 2 1
1 0 0 2 2 1 0 1 0 X 0 2 2 0 1 1 2 1 1 1 0 C 2 0 0 1 0 1 1 0 1 1
1 1 1 1 2 1 0 0 0 1 0 1 1 0 2 2 2 2 0 0 0 1 1 0 1 1 0 1 0 0 0 1
1 D 2 0 2 0 1 1 0 1 0 0 0 1 0 1 1 1 0 1 2 1 0 0 0 1 0 2 0 1 2 1
1 2 1 0 1 0 0 0 2 0 1 1 0 1 0 0 0 H 0 0 0 0 0 1 2 2 0 1 0 1 1 1
1 0 1 0 1 1 1 0 1 0 0 1 2 2 0 1 0 1 0 1 2 1 0 1 1 C 1 1 0 0 0 1
1 2 0 0 0 2 R 0 1 1 0 1 A 1 1 0 0 1 0 1 0 0 0 0 0 0 0 0 2 1 0 1
1 2 1 1 0 1 1 0 1 0 0 0 0 0 1 X 1 2 2 2 0 1 1 0 1 0 1 R 1 1 2 1
1 2 2 B 0 2 2 0 0 D 1 1 1 0 0 0 A 2 1 1 0 2 2 0 2 0 1 0 2 2 B 1
1 1 1 1 1 1 1 1 1 1 1 1 1 1 1 1 1 1 1 1 1 1 1 1 1 1 1 1 1 1 1 1

*** Entity Tinh ***
P - portal
0 - grass
1 - wall
2 - brick (soft wall)
*** Special Entity Tinh ***
A - [Power up Bomb's radius] Item
B - [Power up Player's speed] Item
C - [Increase Bomb's amount] Item
D - [Increase Flame's "max brick can break"] + [Can pass through Flame] Item
*** Entity Dong ***
3 - player
R - enemy random
V - enemy vertical
H - enemy horizontal
F - enemy with finding path
S - enemy find can pass soft wall and lure player(not directly find player)
X - enemy doria random pass soft wall