1 1 1 1 1 1 1 1 1 1 1 1 1 1 1 1 1 1 1 1 1 1 1 1 1 1 1 1 1 1 1 1
1 0 0 0 0 H 0 1 0 0 0 0 0 1 0 0 0 1 0 0 0 1 1 0 0 0 0 0 0 0 1 1
1 0 1 0 1 1 0 1 1 0 1 1 0 1 0 1 0 0 0 1 0 0 H 0 1 1 1 0 1 0 0 1
1 0 0 0 1 0 0 0 0 0 0 0 0 0 0 1 0 1 0 1 1 0 1 0 0 0 1 0 1 1 0 1
1 0 1 0 0 0 1 0 1 0 1 1 F 1 0 1 0 1 0 1 1 0 1 1 1 0 0 0 0 0 0 1
1 0 1 0 0 1 1 0 1 0 0 0 0 0 0 0 0 1 0 0 0 0 1 0 0 0 1 1 0 1 0 1
1 0 1 0 0 0 0 0 0 1 0 1 1 0 1 1 0 0 1 1 0 1 0 0 1 0 0 1 0 1 0 1
1 0 0 0 F 1 0 1 0 0 0 0 0 0 0 0 1 0 0 1 0 1 1 0 1 1 0 0 0 0 0 1
1 0 1 1 0 1 0 1 1 1 0 1 1 0 1 0 X 1 0 0 0 0 1 0 0 0 1 0 1 1 0 1
1 0 0 0 0 0 0 0 0 0 0 0 1 0 1 1 0 1 0 1 1 R 0 0 1 0 0 0 1 1 0 1
1 1 1 0 1 0 0 1 0 1 1 0 1 0 1 0 0 0 F 0 0 1 1 0 0 0 1 0 0 0 0 1
1 0 0 0 1 1 0 0 0 0 1 0 0 0 0 0 1 0 1 0 0 0 1 0 1 1 1 1 0 1 0 1
1 0 1 0 0 0 0 1 1 0 1 0 1 0 1 0 0 0 0 0 1 0 1 0 1 0 0 0 0 1 0 1
1 0 1 A 1 1 S 0 1 0 0 0 0 0 1 1 X 1 1 0 1 0 1 0 0 0 1 1 2 2 2 1
1 D 1 D 0 0 1 0 0 0 1 0 1 1 1 0 0 1 0 0 1 0 0 0 1 1 1 0 2 1 2 1
1 C 1 A 1 0 1 0 1 1 1 0 0 0 0 0 1 1 0 1 1 0 1 1 1 0 0 0 1 1 2 1
1 C B B 1 0 0 0 0 0 0 0 1 1 1 P 0 0 3 0 0 0 0 0 0 0 1 0 2 2 0 1
1 1 1 1 1 1 1 1 1 1 1 1 1 1 1 1 1 1 1 1 1 1 1 1 1 1 1 1 1 1 1 1

*** Entity Tinh ***
P - portal
0 - grass
1 - wall
2 - brick (soft wall)
*** Special Entity Tinh ***
A - [Power up Bomb's radius] Item
B - [Power up Player's speed] Item
C - [Increase Bomb's amount] Item
D - [Increase Flame's "max brick can break"] + [Can pass through Flame] Item
*** Entity Dong ***
3 - player
R - enemy random
V - enemy vertical
H - enemy horizontal
F - enemy with finding path
S - enemy find can pass soft wall and lure player(not directly find player)
X - enemy doria random pass soft wall

