1 1 1 1 1 1 1 1 1 1 1 1 1 1 1 1 1 1 1 1 1 1 1 1 1 1 1 1 1 1 1 1 
1 0 3 0 0 0 0 0 0 0 2 0 0 2 2 0 2 0 0 0 0 0 0 0 0 0 0 0 0 0 0 1
1 0 1 0 1 0 1 2 1 2 1 0 1 2 1 2 1 0 1 0 1 2 1 2 1 0 1 2 1 0 0 1
1 0 0 C D 0 0 0 2 2 2 0 F 0 0 0 0 0 0 0 0 2 0 0 0 0 C 2 0 0 0 1
1 0 1 0 1 0 1 F 1 0 1 0 1 2 1 0 1 0 1 0 1 0 1 0 1 0 1 0 1 0 0 1
1 0 0 0 0 0 A 0 2 0 0 0 0 2 2 0 0 0 0 0 0 0 2 2 0 0 0 0 0 0 0 1
1 0 1 2 1 B 1 0 1 0 1 0 1 0 1 0 1 2 1 0 1 0 1 0 1 2 1 2 1 2 2 1
1 0 2 D 0 0 0 0 0 0 0 0 0 2 2 0 2 2 2 2 0 0 0 0 2 2 0 0 0 0 0 1
1 0 1 0 1 0 1 0 1 0 1 0 1 0 1 2 1 0 1 0 1 0 1 0 1 2 1 2 1 0 0 1
1 0 0 0 0 0 0 0 0 0 2 2 0 0 2 P 2 0 0 0 2 2 0 0 0 0 0 0 0 0 0 1
1 0 1 0 1 0 1 0 1 0 1 0 1 0 1 2 1 0 1 2 1 0 1 0 1 A 1 2 1 0 0 1
1 0 0 0 0 0 2 2 0 0 0 0 0 0 0 0 F 0 0 2 0 0 0 0 0 2 2 2 0 0 0 1
1 0 1 0 1 0 1 0 1 0 1 0 1 0 1 0 1 0 1 0 1 0 1 0 1 0 1 0 1 0 0 1
1 0 0 0 0 F 0 2 2 0 0 0 0 0 2 A 0 0 B 2 2 0 0 0 0 0 0 0 0 0 0 1
1 0 1 2 1 0 1 2 1 0 1 2 1 0 1 0 1 0 1 A 1 0 1 0 1 0 1 2 1 0 0 1
1 0 2 D 2 0 2 B 0 0 0 0 2 2 0 0 0 0 2 2 2 0 0 0 0 0 2 2 2 0 0 1
1 0 0 0 0 0 0 0 0 0 0 0 0 0 0 0 0 0 0 0 0 0 0 0 0 0 0 0 0 0 0 1
1 1 1 1 1 1 1 1 1 1 1 1 1 1 1 1 1 1 1 1 1 1 1 1 1 1 1 1 1 1 1 1 

P - portal
0 - grass
1 - wall
2 - brick (soft wall)
3 - player
R - enemy random
V - enemy vertical
H - enemy horizontal
F - enemy with finding path
A - [Power up Bomb's radius] Item
B - [Power up Player's speed] Item
C - [Increase Bomb's amount] Item
D - [Increase Flame's "max brick can break"] Item
