1 1 1 1 1 1 1 1 1 1 1 1 1 1 1 1 1 1 1 1 1 1 1 1 1 1 1 1 1 1 1 1 
1 0 0 8 0 0 C 4 0 0 D 0 0 0 0 0 0 0 0 0 B 0 0 0 A 0 0 0 0 0 0 1
1 B 1 0 1 6 1 0 1 0 1 0 1 0 1 0 1 0 1 0 1 0 1 0 1 0 1 0 1 A 0 1
1 0 0 B 0 0 0 0 0 0 0 7 0 0 0 0 0 0 0 0 0 0 0 0 0 0 0 0 0 0 0 1
1 6 2 0 2 0 2 0 2 0 2 0 2 0 2 0 2 0 2 0 2 0 2 0 2 0 2 D 2 0 0 1
1 C 0 0 0 0 0 0 0 0 0 0 A 0 0 0 0 0 A 0 0 0 0 0 0 0 0 0 0 0 0 1
1 0 1 0 1 0 1 0 1 0 1 0 1 0 1 0 1 0 1 0 1 0 1 0 1 0 1 0 1 0 0 1
1 0 0 0 0 A 0 0 0 0 D 0 0 7 0 0 0 D 0 0 0 0 0 A 0 0 0 C 0 0 0 1
1 0 2 B 2 0 2 0 2 0 2 0 2 0 2 2 2 0 2 0 2 0 2 0 2 0 2 0 2 0 0 1
1 0 0 0 2 2 2 2 2 2 2 0 B 0 2 5 2 0 B 0 0 0 0 0 0 0 0 0 0 0 0 1
1 0 1 0 1 0 1 3 1 0 1 0 1 0 2 2 2 0 1 0 1 0 1 0 1 0 1 0 1 A 0 1
1 0 0 0 0 A 0 0 0 0 0 0 0 C 0 0 0 8 0 C 0 0 0 0 0 0 0 0 0 0 0 1
1 0 2 0 2 0 2 0 2 0 2 0 2 0 2 0 2 0 2 0 2 0 2 0 2 0 2 0 2 0 0 1
1 0 0 0 0 0 0 0 0 0 0 0 0 0 0 0 0 0 0 0 0 0 0 0 0 0 0 0 0 0 0 1
1 0 1 0 1 0 1 0 1 0 1 0 1 0 1 0 1 0 1 0 1 0 1 0 1 0 1 0 1 0 0 1
1 0 0 0 0 0 0 0 0 0 0 0 0 0 0 0 0 0 0 0 0 0 0 0 0 0 0 0 0 0 0 1
1 0 0 0 0 B 0 0 0 0 0 0 0 0 0 0 0 0 0 0 0 0 A 0 0 0 0 0 0 0 0 1
1 1 1 1 1 1 1 1 1 1 1 1 1 1 1 1 1 1 1 1 1 1 1 1 1 1 1 1 1 1 1 1 

0 - grass
1 - wall
2 - brick
3 - player
5 - portal
6 - enemy vertical
7 - enemy horizontal
8 - enemy random
A - [Power up Bomb's radius] Item
B - [Power up Player's speed] Item
C - [Increase Bomb's amount] Item
D - [Increase Flame's "max brick can break"] Item
